16,16,16,16,16,16,16,16,16
16,10,2,2,2,2,2,2,16
16,2,2,2,2,2,2,2,16
16,2,3,3,3,6,6,6,16
16,2,2,2,2,16,16,16,16
16,2,2,2,2,16,16,16,16
16,16,16,16,16,16,16,16,16